10 - Igazán nehéz pálya
....................
.O%  .X.@  X.   %O:.
...  .*.    . .... .
.*  .@ . . 3. ..*. .
.  2   . *... .  . .
..   . ...... . .. .
.....  .   ..3.    .
........    ........
.  .X .  1  @      .
.4 .  .     . . 2  .
.  .        : .    .
.  :  .       .    .
...........:........
.@ *.  .    .   .@ .
..  .  ...@ . 4 .* .
.  . @ .    .   . X.
.      .  ... ...  .
.:.  1 .  ...~    @.
.O.@   .  %O.  .   .
....................