9 - pálya
...................
. .     %    :   X.
. . ... . .........
.O  .   .   :     .
. ... ......... . .
. .@ *.       .O. .
. ..... ..... ... .
.   .       . .   .
... . ..... . . . .
.O  . .   . . . .*.
... . . . . . . . .
.   .1  . . .   .1.
. ....... .........
.       . .     : .
..... . .:. ..... .
.  X. . .   .   . .
. ... . ..... . . .
.     .       . .X.
...................