11 - pálya
...................
.O.     % *  : * X.
.%. ... . .........
.   .   .   :     .
. ... .........%. .
. .@ *.  *  * .O. .
. ..... ..... ... .
.   .*      . .   .
... . ..... . . . .
.O% . .   . .*. .*.
... . . . . . . . .
.   .1  . . .   .1.
. ....... .........
.       . .     : .
..... . .:. ..... .
.  X. . .   .   . .
. ... . ..... . . .
. *   .   *   . .X.
...................