149
...............................
.   .   .   .   .   .    .   .
.   .   .   .   .   .    .   .
.   .   .   .   .   .    .   .
.. ... ... ... ... ...  ... ..
.   .   .   .   .   .    .   .
.       %                    .
.   .   .   .   .   .    .   .
.. ... ... ...%... ...  ... ..
.   .   .   .   .   .    .   .
.       %   % O %   %    @   .
.   .   .   .   .   .    .   .
.. ... ... ...%... ...  ... ..
.   .   .   .   .   .    .   .
.                            .
.   .   .   .   .   .    .   .
.. ... ... ... ... ...  ... ..
.   .   .   .   .   .    .   .
.                            .
.   .   .   .   .   .    .   .
.. ... ... ... ... ...  ... ..
.   .   .   .   .   .    .   .
.   .   .   .   .   .    .   .
.   .   .   .   .   .    .   .
..............................
