8 - Igazán nehéz pálya
....................
.O   .*.@   .    O .
. .  . .  C . .... .
..  .  . .  . ..*. .
.. B   .  ... .  . .
..   . ..%  . . .. .
.....  .   ..C.    .
........    ........
.  .X .  A  @      .
.D .  .     . . B  .
.  .        : .    .
.  :  .       .    .
...........:........
.@ *.  .    .   .@ .
..  .  ...  . D .* .
.  . @ .    .   .  .
.      .  ... ...  .
. .  A .    .~    @.
.O @   .   O.  .   .
....................