8 - Igazán nehéz pálya
....................
.O   .*.@   .    O .
. .  .X.  3 . .... .
..  .@ . .  . ..*. .
.. 2   .  ... .  . .
..   . ..%  . . .. .
.....  .   ..3.    .
........    ........
.  .X .  1  @      .
.4 .  .     . . 2  .
.  .        : .    .
.  :  .       .    .
...........:........
.@ *.  .    .   .@ .
..  .  ...@ . 4 .* .
.  . @ .    .   .  .
.      .  ... ...  .
. .  1 .    .~    @.
.O @   .   O.  .   .
....................