9 - Igazán nehéz pálya.
....................
.    .*.X   .      .
. .  . .  C . .... .
..  .  . .  . ..*. .
.. B   .  ... .  . .
..   . ..%  . . .. .
.....  .   ..C.    .
........    ........
.  .  .  A  X      .
.D .  .     . . B  .
.  .        : .    .
.  :  .       .    .
...........:........
.X *.  .    .   .X .
..  .  ...  . D .* .
.  . X .    .   .  .
.      .  ... ...  .
. .  A .    .~    X.
.  X   .   O.  .   .
....................