149
...............................
. * .   .   .   .   .    . * .
.   .   .   .   .   .    .   .
.   .   .   .   .   .    .   .
.. ... ... ... ... ...  ... ..
.   .   .   .   .   .    .   .
.       %                    .
.   .   .   .   .   .    .   .
.. ... ... ...%... ...  ... ..
.   .   .   .X  .   .    .   .
.       %   % O %   %    @   .
.   .   .   .   .   .    .   .
.. ... ... ...%... ...  ... ..
.   .   .   .   .   .    .   .
.                            .
.   .   .   .   .   .    .   .
.. ... ... ... ... ...  ... ..
.   .   .   .   .   .    .   .
.                            .
.   .   .   .   .   .    .   .
.. ... ... ... ... ...  ... ..
.   .   .   .   .   .    .   .
.   .   .   .   .   .    .   .
. * .   .   .   .   .    . * .
..............................
