..........
.O~~~~a~*.
....... ..
.X~~~@.  .
.  .  A  .
...........