..........
.O  a *  .
....... ..
.X~~~@.  .
.  .  A
..........

